_______________________________________________¶¶_________
_______¶______________________________________¶¶¶_________
_______¶¶¶¶_________________________________¶¶¶¶¶_________
_______¶¶¶¶¶¶¶_____________________________¶¶¶¶¶¶_________
________¶¶¶¶¶¶¶¶¶________________________¶¶¶¶¶¶¶¶_________
________¶¶¶¶¶¶¶¶¶¶¶_____________________¶¶¶¶¶¶¶¶¶_________
_________¶¶¶¶¶¶¶¶¶¶¶¶__________________¶¶¶¶¶¶¶¶¶¶_________
_________¶¶¶¶¶¶¶¶¶¶¶¶¶________________¶¶¶¶¶¶¶¶¶¶¶_________
__________¶¶¶¶¶¶¶¶¶¶¶¶¶¶_____________¶¶¶¶¶¶¶¶¶¶¶__________
___________¶¶¶¶¶¶¶¶¶¶¶¶¶¶¶___________¶¶¶¶¶¶¶¶¶¶¶__________
____________¶¶¶¶¶¶¶¶¶¶¶¶¶¶¶__________¶¶¶¶¶¶¶¶¶¶¶__________
_____________¶¶¶¶¶¶¶¶¶¶¶¶¶¶¶________¶¶¶¶¶¶¶¶¶¶¶___________
_______________¶¶¶¶¶¶¶¶¶¶¶¶¶¶_______¶¶¶¶¶¶¶¶¶¶¶___________
________________¶¶¶¶¶¶¶¶¶¶¶¶¶¶¶_____¶¶¶¶¶¶¶¶¶¶____________
__________________¶¶¶¶¶¶¶¶¶¶¶¶¶¶___¶¶¶¶¶¶¶¶¶¶¶____________
____________________¶¶¶¶¶¶¶¶¶¶¶¶¶__¶¶¶¶¶¶¶¶¶¶_____________
________________________¶¶¶¶¶¶¶¶¶¶_¶¶¶¶¶¶¶¶¶______________
___________________________¶¶¶¶¶¶¶¶¶¶¶¶¶¶¶¶_______________
__________________________¶¶¶¶¶¶¶¶¶¶¶¶¶¶¶¶________________
______________________¶¶¶¶¶¶¶¶¶¶¶¶¶¶¶¶¶¶¶_________________
___________________¶¶¶¶¶¶¶¶¶¶¶¶¶¶¶¶¶¶¶¶¶¶¶________________
_________________¶¶¶¶¶¶¶¶¶¶¶¶¶¶¶¶¶¶¶¶¶¶¶¶¶¶_______________
________________¶¶¶¶¶____¶¶¶¶¶¶¶¶¶¶¶¶¶¶¶¶¶¶¶______________
_______________¶¶¶¶¶¶____¶¶¶¶¶¶¶¶¶¶¶¶¶¶¶¶¶¶¶______________
______________¶¶¶¶¶¶¶¶¶¶¶¶¶¶¶¶¶¶¶¶¶¶¶¶¶¶¶¶¶¶¶_____________
______________¶¶¶¶¶¶¶¶¶¶¶¶¶¶¶¶¶¶¶¶¶¶¶¶¶¶¶¶¶¶¶_____________
______________¶¶¶¶¶¶¶¶¶¶¶¶¶¶¶¶¶¶¶¶¶¶¶¶¶¶¶¶¶¶¶_____________
______________¶¶¶¶¶¶¶¶¶¶¶¶¶¶¶¶¶¶¶¶¶¶¶¶¶¶¶¶¶¶______________
______________¶¶¶¶¶¶¶¶¶¶¶¶¶¶¶¶¶¶¶¶¶¶¶¶¶¶¶¶¶¶______________
________________¶¶¶¶¶¶¶¶¶¶¶¶¶¶¶¶¶¶¶¶¶¶¶¶¶¶¶¶______________
__________________¶¶¶¶¶¶¶¶¶¶¶¶¶¶¶¶¶¶¶¶¶¶¶¶¶¶______________
____________________¶¶¶¶¶¶¶¶¶¶¶¶¶¶¶¶¶¶¶¶¶¶¶¶______________
________________________¶¶¶¶¶¶¶¶¶¶¶¶¶¶¶¶¶¶¶_______________
_______________________¶¶¶¶¶¶¶¶¶¶¶¶¶¶¶¶¶¶_________________
_______________________¶¶¶¶¶¶__¶¶¶¶¶¶_____________________
___________________¶¶¶__¶¶_¶¶__¶¶_____¶¶¶¶________________
____________________¶¶¶¶¶¶¶¶¶¶_¶¶¶¶¶¶¶¶___________________
____________________¶¶¶¶¶¶¶¶¶¶_¶¶¶________________________
____________________¶¶____¶¶¶¶____________________________
____________________________¶¶____________________________